----F------
-H---W-----
-Q----M----
-----------
M----Q-----
-W---H-----
--F-------M
-----------
-----------
-----W--QH-
------F----
